BBBBBBBBBBBBBBBBBBBBBBBBBBBBBBBBBBBB
B                                  B
B                                  B
B                                  B
B                             C    B
B                       BBBBBBBBBBBB
BBB              C                 B
B               BB                 B
B               BB                 B
B        H      BB         C  H    B
BBBBBBBBBBBBBBBBBBBBBBBBBBBBBBBBBBBB