BBBBBBBBBBBBBBBBBBBBBBBBBBBBBBBBBBBB
B                                  B
B                                  B
B                                  B
B                                  B
B                       BBBBBBBBBBBB
BBB                                B
B                C                 B
B                BB                B
B        H   C   BB      C    H    B
BBBBBBBBBBBBBBBBBBBBBBBBBBBBBBBBBBBB