BBBBBBBBBBBBBBBBBBBBBBBBBBBBBBBBBBBB
B                                  B
B                                  B
B                                  B
B                                  B
B                       BBBBBBBBBBBB
BBB                                B
B               BB                 B
B               BB                 B
B               BB                 B
BBBBBBBBBBBBBBBBBBBBBBBBBBBBBBBBBBBB