BBBBBBBBBBBBBBBBBBBBBBBBBBBBBBBBB
B                               B
B                               B
B                               B
B                               B
B                       BBBBBBBBB
BBB                             B
B                C              B
B                BB             B
B        H   C   BB      C    H B
BBBBBBBBBBBBBBBBBBBBBBBBBBBBBBBBB